SO     ./texture/stone.xpm
WE       ./texture/water.xpm
EA     ./texture/froisse.xpm
NO    ./texture/jaune.xpm
F     255,255,255
S               ./sprite/corgi.5.xpm
C         39,195,218
R                    400 400


11111111111111  111111111111111111111
10200000000001  11100000200000001
100000000000111111000002200000001
10000200000000000200022200000001
10000000000000100002222222222201
1000000000000N0000000000000000011
1100000000000011111111111111111111111111
1111001111111111111111111
1000001
1110111
1111111



